R 1280 720

NO ./xpm/bluestone.xpm
SO ./xpm/greystone.xpm
WE ./xpm/purplestone.xpm
EA ./xpm/redbrick.xpm

S ./xpm/barrel.xpm

F  50,205,50
C  135,206,235

       1111111111111111111111111111
       1S00020000110002000000000001
       1011000001110000002000001001
11111111001000000000020000000001001
10110000011100000000000010011111111
1000000000110000011101111001       
1111011111111101110000001001       
1111011111111101110101001001       
1100000011010101110000001001       
1000200000000000110000021001       
1000000000000200110101001001       
1100000011010200111101111001       
1111011111110000111101111201       
1111111111111111111111111111       