R 1920 1080

NO ./xpm/bluestone.xpm
SO ./xpm/greystone.xpm
WE ./xpm/purplestone.xpm
EA ./xpm/redbrick.xpm

S ./xpm/barrel.xpm

F  50,205,50
C  135,206,235

111111111111111111111111111
1000S20000110002000000000011
1211000001110000002000001001
1001000000000020000000001001
1011000001110000000000001001
1000000001 10000011101111001
1111011111 11101110000001111
11110111111111011101010011
1100000011010101110000001111
1000200000000000110000021001
10000000000002001101010010011111
11111100000011010200111101111001
    1111011111110000111101111201
    1111111111111111111111111111